        ##     #
 ### ###B  ### #
#    #  ##  ## #
# #### #  #     
#    # ## #### #
 ### #    #     
       #     #  
A ###   ####    